#########
# P     #
### X X #
# O   X ##########
#  X# O  #  O    #
#   O#           #
############   ###
           ####
