#########
#       #
### X X #
# O   X ##########
#  X# OX #  O    #
#  PO#       #O  #
############   ###
          #    #
          #    #
          #    #
          ######
